1111111111111111
10C00000100C0001
1000000011110001
1010000000000001
10P00110C0000001
100111100000E001
1111111111111111